Nome e simbolos do top 50 stocks para investir

Anheuser-Busch InBev - BUD
Anthem - ANTM
Barclays - BCS
Bausch Health - BHC
Boston Properties - BXP-PB
Canopy Growth - CGC
CBS Corparation - CBS
Centrica pl - CPYYY
CK Asset Holdings Limited - CHKGF
Comcast Corporation - CMCSA
Dell Technologies Inc. - DELL
Deutsche Bank Aktiengesellschaft - DB
Energy Transfer Partners, L.P. PFD UNIT SER D - ETP-PD
Fast Retailing Co. Ltd. - FRCOY
Ford Motor Company - F
General Electric Company - GE
Gilead Sciences Inc. - GILD
Hammerson plc - HMSN
Harley-Davidson Inc. - HOG
InterGlobe Aviation Limited - INDIGO.NSE
IQVIA Holdings Inc. - IQV
ITVI - ITVI
Johnson Controls International plc - JCI
Kering SA - PPRUY
Knight-Swift Transportation Holdings Inc. - KNX
The Kroger Co. - KR
L Brands Inc. - LB
Lennar Corporation - LEN
Manulife Financial Corporation - MFC
Marathon Petroleum Corporation - MPC
McDermott International Inc. - MDR
NIKE Inc. - NIKE
NXP Semiconductors N.V. - NXPI
Osram Licht AG - OSAGY
Petrobras Distribuidora S.A. - BRDT3.SAO
Prudential plc - PUK
Pyxus International Inc. - PYX
Range Resources Corporation - RRC
Public Joint Stock Company Rosneft Oil Company - OJSCY
SoftBank Group Corp. - SFTBY
Synchrony Financial - SYF
Tableau Software Inc - DATA
Tesla Inc. - TLSA
Teva Pharmaceutical Industries Limited - TEVA
Vodafone Group Plc - VOD
Wabtec Corporation - WAB
WPP plc - WPP
Xylem Inc. - XYL
Apple Inc. - AAPL
 
 




